GoogleAPI	KEYWORD1
GoogleFile	KEYWORD1
GoogleFilelist	KEYWORD1



printConfig	KEYWORD2
getState	KEYWORD2
printConfig	KEYWORD2

clearConfig	KEYWORD2
refreshToken KEYWORD2
getNumFiles	KEYWORD2
getFileName	KEYWORD2
getFileId	KEYWORD2

searchFile	KEYWORD2
uploadFile	KEYWORD2
printAppFiles	KEYWORD2
createAppFolder	KEYWORD2

access_token		KEYWORD3
verification_url	KEYWORD3
user_code	KEYWORD3
expires_in	KEYWORD3
appFolderId	KEYWORD3


MessageNoData	LITERAL1
MessageText	LITERAL1
MessageQuery	LITERAL1
MessageLocation	LITERAL1
KeyboardButtonURL	LITERAL1
KeyboardButtonQuery	LITERAL1
